L--------
---------
---------
---RP----
----P-S--
---VP----
----P----
-H-------
----F----
---------
---------
---------
---------
---------
